# /etc/skel/.bashrc ---> FOR ALL USER
# /home/UserName/.bashrc ---> FOR EACH SPECIFIC USER

# COMPRESSION & DECOMPRESSION
alias extract='tar -xvf'

# FLATPAK
alias flatpak-i4='flatpak install --from' # WITH https 
alias flatpak-i7='flatpak install flathub -y' # FOR ONLINE
alias flatpak-i='flatpak install' # FOR OFFLINE WITH FORMAT <ApplicationID>.flatpakref
alias flatpak-r='flatpak run'
alias flatpak-udd='flatpak uninstall --delete-data -y'
alias flatpak-uu='flatpak uninstall --unused'
alias flatpak-l='flatpak list'
alias flatpak-s='flatpak search'
alias flatpak-u='flatpak update -y'
alias flatpak-uv='flatpak update -v' # TO FIX LIKE THIS error: runtime/org.freedesktop.Platform/x86_64/1.6 not installed

# SNAP
alias snap-i='sudo snap install'
alias snap-rm='sudo snap remove'
alias snap-la='snap list --all'
alias snap-f='snap find'
alias snap-c='snap changes'
alias snap-rf='sudo snap refresh' # UPDATE ALL OR ONLY <package>
alias snap-rl='sudo snap refresh --list' # LIST UPDATE TO VIEW
alias snap-rv='sudo snap revert' # <package>
alias snap-='sudo snap refresh' # <package> --channel=<channel_name>

# INSTALL SNAP APPS OFFLINE
alias snap-d='snap download' # <package_name>
alias snap-a='snap ack' # <package_name.assert>
alias snap-i='sudo snap install' # <package_name.snap>

# APT
alias apt-uu='sudo apt update && sudo apt upgrade -y'
alias apt-udu='sudo apt update && sudo apt dist-upgrade -y'
alias apt-s='apt search'
alias apt-cp='apt-cache pkgnames'
alias apt-i='sudo apt install -y'
alias apt-li='apt list --installed'
alias apt-r='sudo apt remove -y' # REMOVE APP BUT KEEP CONFIG
alias apt-p='sudo apt purge -y' # DELETE CONFIG WHEN REMOVE APP
alias apt-ar='sudo apt autoremove -y' # REMOVE DEPENDENCIES OF APPS WAS REMOVE
alias apt-fu='sudo apt full-upgrade -y'
alias apt-inu='sudo apt install CreateVariableToEnterPackageName --no-upgrade' # su dung bien
alias apt-ispec='sudo apt install PackageName=VersionNumber' # su dung bien
alias apt-lu='apt list --upgradable'
alias apt-lav='apt list --all-versions'

# YUM
alias yum-s='yum search'
alias yum-i='sudo yum install -y'
alias yum-r='sudo yum remove -y'
alias yum-u='yum upgrade -y'

# DNF
alias dnf-s='dnf search'
alias dnf-i='sudo dnf install -y'
alias dnf-ri='sudo dnf reinstall -y'
alias dnf-r='sudo dnf remove -y'
alias dnf-uu='sudo dnf update -y && sudo dnf upgrade -y'
alias dnf-ar='sudo dnf autoremove -y'

# NETWORK
alias ipp='curl icanhazip.com'
alias iplh='hostname -I'
alias centos='ssh centos@IP'
alias ubuntu='ssh ubuntu@IP'
alias speedtest='curl -s https://raw.githubusercontent.com/sivel/speedtest-cli/master/speedtest.py | python3 -'

# APPS
alias svim='sudo vim'
alias snano='sudo nano'
alias pt3='python3'
alias tmux-ls='tmux list-sections'
alias tmux-ks='tmux-session -t'
alias tmux-kas='tmux kill-session -a'
alias commit='git commit -m "`date +%Y%m%d_%H%M`"'

# OTHER
alias sp='systemctl suspend -i'
alias sn='systemctl poweroff -i'
alias rb='systemctl reboot -i'
alias ...='cd ../../../'
alias ....='../../../../'
alias reload='source ~/.bashrc'